#######
#     #
#  P  #
#  X O#
#     #
#######
