############
#          #
#   XX     #
#   X  O   #
#  P   OO  #
#     XX   #
#          #
############
