########
#  O   #
#  XX  #
#  P   #
#   O  #
########
